111111111111111111111111111111111111111111111111111111
11100111111110000111C0001C011001001C010001110000010011
1111001111C010001110000010111001001C010000000000010011
11110000010000001110C01000111001001C010001110001000011
1111010100010C000100010000000001001C010001110000010011
1111C10111100100011011000111100100100000011100X0010011
1110010000000100011000C101111001001C010001110000010011
1110100011010100000C000100111001001C010001110000010011
100C0011000101000000100011111001001C010001110000010011
101110000PE0000000C0000000111001001C01000X110000010011
1011101100011011001100C001111001000C000001110000010001
10010010010110110C00010001111001001C010001110000010001
110101101100001100010010001110010010010000000000010011
110100001110011C00C0100010111001000C010001110000010011
1101110C000100100000010C01111001001C010001110000010011
110000111111100C00000100011110010010010001110000010011
11110000111110000CC0011000111001001C010001110000010011
111C011011110010001C010001111001001C010001110000010011
1101011000C00110001CC0100C111001001C010001110000010001
1101011000C001100C10001000111001001C010001110000010011
1101011000C001100C10001000111001001C010001110000010011
1101011000C0011X0C10001000111001001C010000000000010011
111C011011110010001C010010111000001C010000000000010011
1101011000C00110001C001010000001001C010001110000010011
1101011000C001100C10001000011001001C000001110000010011
1101011000C001100C10000000111001000C010001110000010011
1101011000C001100C10001000111001001C010001110000000001
111111111111111111111111111111111111111111111111111111